START	S T AA R T
STOP	S T AA P
CONTINUE	K AH N T IH N Y UW
PAUSE	P AO Z
EXIT	EH G Z IH T
EXIT(2)	EH K S AH T
SETTING	S EH T IH NG
BACK	B AE K
RESUME	R IH Z UW M
RESUME(2)	R IY Z UW M
RESUME(3)	R EH Z AH M EY
ONE	W AH N
ONE(2)	HH W AH N
TWO	T UW
THREE	TH R IY
FOUR	F AO R
FIVE	F AY V
SIX	S IH K S
YES	Y EH S
NO	N OW
TRUE	T R UW
FALSE	F AO L S
RED	R EH D
GREEN	G R IY N
BLUE	B L UW
ORANGE	AO R AH N JH
ORANGE(2)	AO R IH N JH
YELLOW	Y EH L OW
BROWN	B R AW N
PINK	P IH NG K
